NO ./textures/oupi_goup.xpm
SO ./textures/oupi_goup.xpm
WE ./textures/soup.xpm
EA ./textures/soup.xpm

F 220,100,0
C 225,30,0

11111E
100001
111111