NO ./textures/FT_MC.xpm
SO ./textures/FT_MC.xpm
WE ./textures/FT_MC.xpm
EA ./textures/FT_MC.xpm

F 40,8,55 	
C 40,8,55 



111111111
1S0000001
100000001
100000001
100000001
100000011
100000001
11111111
1111


111111111