NO ./textures/FT_MC.xpm
SO ./textures/FT_MC.xpm
WE ./textures/FT_MC.xpm
EA ./textures/FT_MC.xpm

F 40,8,55 	
C 40,8,55 


11111111111111111111111111
10000000000011100000100001
1000000000001 100000100001
10000000000010100000100001
10000000000010100000100111
1000000001110000000000
10000000000000000001000001
10000000000000000000000001
1111110N111111111111111111
1			0			111
111111111111111111111111111