NO ./textures/FT_MC.xpm
SO ./textures/FT_MC.xpm
WE ./textures/FT_MC.xpm
EA ./textures/FT_MC.xpm

F 40,8,55 
C 82,4,4

11111111111111111111111111
10000000000011100000100001
1000000000001 100000100001
10000000000010100000100001
10000000000010100000100001
10000000011100000000000001
10000000000000000001000001
10000000000000000000000001
1111110N111111111111111111
1			0			111
1111111  1111111111111111111
11111111