NO ./textures/FT_MC.xpm
SO ./textures/FT_MC.xpm
WE ./textures/FT_MC.xpm
EA ./textures/FT_MC.xpm

F 40,8,55 
C 82,4,4

11111111111111111111111111
10000000000011100000100001
1000000000001 100000100001
10000000000010100000100001
10000000000010100000100001
1000000001110N000000000001
10000000000000000000000001
10000000000000000000000001
11111111111111111111111111