NO ./textures/Crate.xpm
SO ./textures/Crate.xpm
WE ./textures/Crate.xpm
EA ./textures/Crate.xpm


C 52,22,88
F 43,52,84

111111111111111111111
111111111110000000001
10000000000000000E001
100000000000000000001
100000000000000111111
100			 001
100			 001
100			 001
100			 001
1000000000000001
1000000000000001
100			 001
100			 001
100			 001
100			 001
1000000000000001
1000000000000001
1000000000000001
1111111111111111