NO ./textures/FT_MC.xpm
SO ./textures/sand.xpm
WE ./textures/obsi.xpm
EA ./textures/obsi.xpm

C 245,73,0 
F 101,98,96 	


11111111111111111111111111
1110S0111				11111111111111111
11110001111111111111111111
11111000111111111111111111
11111100000000000000000001
11111110001111111111110001
11111111000111111111100011
11111111100011111111000111
11111111110001111110001111
11111111111000111000011111
11111111111000110001111111
11111111111000000011111111
11111111111000000011111111
11111111111111111111111111