NO ./textures/tile11.xpm
SO ./textures/tile11.xpm
WE ./textures/sand.xpm
EA ./textures/sand.xpm

F 153,51,255
C 204,102,0

111111
10E001
111111