NO ./textures/ye.png
SO ./textures/ye.png
WE ./textures/ye.png
EA ./textures/ye.png



F 220,100,0
C 225,30,0

11111
11001
110N1
11001
11101
10001
11
10011
11101
11111
11 11
11  1
 1  1
    1