NO ./textures/ye.png
SO ./textures/ye.png
WE ./textures/ye.png
EA ./textures/ye.png



F 220,100,0
C 225,30,0





    11111111 11111111111111111111
1111001111110111111111111111111001
1000001111111100111111100011111
100000000011111  111111111110000
111111111111111   11111111111111