NO ./textures/ye.png
SO ./textures/ye.png
WE ./textures/ye.png
EA ./textures/ye.png



F 220,100,0
C 225,30,0





11111111 11111111111111111111
